000000000000000000000000000
000000000000000000000000000
000000000000000000000000000
000000000000000000000000000
000000000000000000000000000
000000000000000000000000000
000000000000000000000000000
000000000000000000000000000
000000000000000000000000000
000000000002000000000000000
000000000000000000000000000
000000000000000000000000000
000000000000000000000000000
000002000121210000000000000
000000000000000000000033000
000000000000000003300033000
040000000000000003300033000
111111111111111111111111111
111111111111111111111111111
111111111111111111111111111