000000000000000000000000000
000000000000000000002000000
000000000000000000000000000
000000000000000000011100000
000000000000000000000000000
000000000000001110000000000
000000000000000000000000000
000000000000000000000000000
000001110000000000000000000
000000000000000000001110000
000000000000000000000000000
000000000000000000000000000
000000000000001110000111100
000000000000000000000000000
000000000003000000000000000
000000003003000000000000000
040003003003000000000000000
111111111111111111111111111
111111111111111111111111111
111111111111111111111111111